00000000000000000000000000000000000000000000000000000000000000000000000000000000
00000000000000000000000000000000000000000000000000000000000000000000000000000000
00000000000000000000000000000000000000000000000000000000000000000000000000000000
00000000000000000000000000000000000000000000000000000000000000000000000000000000
00000000000000000000000000000000000000000000000000000000000000000000000000000000
00000000000000000000000000000000000000000000000000000000000000000000000000000000
00000000000000000000000000000000000000000000000000000000000000000000000000000000
00000000000000000000000000000000000000000000000000000000000000000000000000000000
00000000000000000000000000000000000000000000000000000000000000000000000000000000
00000000000000000000000000000000000000000000000000000000000000000000000000000000
00000000000000000000000000000000000000007000000000000000000000000000000000000000
00000000000000000070000000000000004222223000000000000000000000000000000000000000
00000000000000000430000000000000641111111300000000000000043000000000000000000000
00000000000000042112300000000000000111111135000000000004211230000000000000000000
00000000000000411111130000000000000011110000000000000041111113500000000000000000
00000000423000001111100000000000000001000000000042300000111110000000000000000000
00000004111300000111000000000000000000000000000411130000011100000000000000000000
00006421111130000010000000000000000000430000042111113000001000000000000000000742
00000011011000000000000000000000000042113000001101100000000000000000000000004211
00000000000000000000000000000000000411111300000000000000000000000000000000041111
00000000000000000000000000000000004111111123000000000000000000000000000000411111
22222222222223000000000422222222221111111111222222222300000000000000222222111111
11111111111111300000004111111111111111111111111111111122300000000000111111111111
11111111111111130000041111111111111111111111111111111111122300000000001111111111
11111111111111113000411111111111111111111111111111111111111123000000000000000000
11111111111111111300911111111111111111111111111111111111111111230000000423000000
11111111111111111800911111111111111111111111111111111111111111112222300000070000
11111111111111111800911111111111111111111111111111111111111111111110000000423000
11111111111111111800911111111111111111111111111111111111111100000000423000000000
11111111111111111800911111111111111111111111111111111111000000000000000004230000
00000000000000000000000000000000000000000000000000000000000000000000000000000000
00000000000000000000000000000000000000000000000000000000000000000000000000000000
00000000000000000000000000000000000000000000000000000000000000000000004222300000
00000000000000000000000000000000000000000000000000000000000000000423000000000000
00000000000000000000000000000000000000642222222222223000042223000000000000000000
00000000000422222222222230000422223000000111111111100000000110000000000000000000
00000000000011111111111100000000100000000001111100000000000000000000000000000000
00000000000000011111500000000000000000000000010000000000000000000000000000000000
00000000000000001100000000000000000000000000000000000000000000000000000000000000
00000000000000000000000000000000000000000000000000000000000000000000000000000000
00000000000000000000000000000000000000000000000000000000000000000000000000000000
00000000000000000000000000000000000000000000000000000000000000000000000000000000
