11111111111111111111111111111111111111111111111111111111111111111111111111111111
11111111111111800000000000000000000000000000000000000000000000000000000000000000
11111111111111800000000000000000000000000000000000000000000000000000000000000000
11111111111111800000000000000000000000000000000000000000000000000000000000000000
11111111111111800000000000000000000000000000000000000000000000000000000000000000
11111111111111800000000000000000000000000000000000000000000000000000000000000000
11111111111111800000000000000000000000000000000000000000000000000000000000000000
11111111111111800000000000000000000000000000000000000000000000000000000000000000
11111111111111800000000000000000000000000000000000000000000000000000000000000000
11111111111111800000000000000000000000000000000000000000000000000000000000000000
11111111111111800000000000000000000000000000000000000000000000000000000000000000
11111111111111800000000000000000000000000000000000000000000000000000000000000000
11111111111111800000000000000000000000000000000000000000000000000000000000000000
11111111111111800000000000000000000000000000000000000000000000000000000000000000
11111111111111800000000000000000000000000000000000000000000000000000000000000000
11111111111111800000000000000000000000000000000000000000000000000000000000000000
11111111111111800000000000000000000000000000000000000000000000000000000000000000
11111111111111800000000000000000000000000000000000000000000000000000000000000000
11111111111111800000000000000000000000000000000000000000000000000000000000000000
11111111111111800000000000000000000000000000000000000000000000000000000000000000
11111111111111800000000000000000000000000000000000000000000000000000000000000000
11111111111111800000000000000000000000000000000000000000000000000000000000000000
11111111111111800000000000000000000000000000000000000000000000000000000000000000
11111111111111800000000000000000000000000000000000000000000000000000000000000000
11111111111111800000000000000000000000000000000000000000000000000000000000000000
11111111111111800000000000000000000000000000000000000000000000000000000000000000
11111111111111800000000000000000000000000000000000000000000000000000000000000000
11111111111111800000000000000000000000000000000000000000000000000000000000000000
11111111111111800000000000000000000000000000000000000000000000000000000000000000
11111111111111800000000000000000000000000000000000000000000000000000000000000000
11111111111111800000000000000000000000000000000000000000000000000000000000000000
11111111111111800000000000000000000000000000000000000000000000000000000000000000
11111111111111800000000000000000000000000000000000000000000000000000000000000009
11111111111111800000000000000070000000000000000000000000000070000000000000000041
11111111111111800000004222222222222223000000000000000000422222230000000000004211
11111111111111800000041111111111111111300000000000000000001110000000000000041111
11111111111111800000000011111111111110000000000000000000000000000000000070411111
11111111111111800000000000001111111000000042222230000000000000000000004222111111
11111111111111800000000000000011100000000000011100000000000000000004221111111111
11111111111111800000000000000000000000000000000000000000000000000041111111111111
11111111111111800000000000000000000000000000000000000000000000000411111111111111
11111111111111122222222222222222222222222222222222222222222222222111111111111111
11111111111111111111111111111111111111111111111111111111111111111111111111111111
11111111111111111111111111111111111111111111111111111111111111111111111111111111
11111111111111111111111111111111111111111111111111111111111111111111111111111111
11111111111111111111111111111111111111111111111111111111111111111111111111111111
11111111111111111111111111111111111111111111111111111111111111111111111111111111
11111111111111111111111111111111111111111111111111111111111111111111111111111111
11111111111111111111111111111111111111111111111111111111111111111111111111111111
11111111111111111111111111111111111111111111111111111111111111111111111111111111
11111111111111111111111111111111111111111111111111111111111111111111111111111111